aktiv = pasiv
aktiva = pasiva
aktivan = pasivan
aktivni = pasivni
aktivnost = pasivnost
alkoholni = bezalkoholni
augmentativ = deminutiv
beskonačan = konačan
beskonačnost = konačnost
besmislen = smislen
besmrtnost = smrtnost
bezalkoholni = alkoholni
bezbrižan = zabrinut
bezobziran = obziran
bezosjećajan = osjećajan
bezvrijedan = vrijedan
bezvrijedno = vrijedno
bijel = crn
bivši = budući
bjelogorica = crnogorica
bjelogorični = crnogorični
blag = strog
blagost = strogost
blizak = dalek
blizina = daljina
blizu = daleko
bogat = siromašan
bogataš = siromah
bogatašica = siromahinja
bogatstvo = siromaštvo
bojažljiv = hrabar
bojažljivost = hrabrost
bolest = zdravlje
bolestan = zdrav
bratski = sestrinski
brz = spor
bučan = tih
budući = bivši
budućnost = prošlost
čest = rijedak
često = rijetko
cilj = start
čist = prljav
crn = bijel
crnogorica = bjelogorica
crnogorični = bjelogorični
da = ne
dalek = blizak
daleko = blizu
daljina = blizina
dan = noć
dati = uzeti
debeo = mršav
debljina = mršavost
deminutiv = augmentativ
desni = lijevi
dešnjak = ljevak
dešnjakinja = ljevakinja
desno = lijevo
dignuti = spustiti
dignuti = spustiti
dijeliti = množiti
dijeljenje = množenje
direktan = indirektan
div = patuljak
divlji = domaći
dizati = spuštati
djeljiv = nedjeljiv
dnevni = noćni
dobar = loš
dobro = loše
dolazak = odlazak
dolje = gore
donijeti = odnijeti
donji = gornji
donositi = odnositi
donositi = odnositi
dopodne = popodne
dosad = odsad
dosada = zabava
dosadan = zabavan
dovoljan = nedovoljan
drukčiji = isti
dubok = plitak
dugačak = kratak
enklitika = proklitika
glasan = tih
glup = pametan
gore = dolje
gornji = donji
grijati = hladiti
grub = nježan
grubo = nježno
gust = rijedak
hladan = vruć
hladiti = grijati
imati = nemati
indirektan = direktan
isključiti = uključiti
ispod = iznad
ispred = iza
isti = drukčiji
istočni = zapadni
istok = zapad
iza = ispred
izgubiti = pobijediti
izići = ući
izlaz = ulaz
izlaziti = ulaziti
iznad = ispod
iznajmljivati = unajmljivati
iznajmiti = unajmiti
iznajmljivanje = unajmljivanje
izuti = obuti
izuvanje = obuvanje
izuvati = obuvati
jak = slab
jakost = slabost
jednodimenzijski = višedimenzijski
jednokatni = višekatni
jednokatnica = višekatnica
jednokratan = višekratan
jeftin = skup
jučer = sutra
jug = sjever
jutro = večer
jutros = večeras
južni = sjeverni
konačan = beskonačan
konačnost = beskonačnost
korist = šteta
kraj = početak
kratak = dugačak
kriv = nevin
krut = savitljiv
lagan = težak
lijep = ružan
lijevi = desni
lijevo = desno
ljetni = zimski
ljevak = dešnjak
ljevakinja = dešnjakinja
ljubav = mržnja
loš = dobar
loše = dobro
marljiv = lijen
marljivost = lijenost
minus = plus
mir = rat
mlad = star
mlado = staro
mladost = starost
množenje = dijeljenje
množiti = dijeliti
mršav = debeo
mršavost = debljina
mrtav = živ
mrziti = voljeti
mržnja = ljubav
napad = obrana
navući = svući
ne = da
nedjeljiv = djeljiv
nedovoljan = dovoljan
negativ = pozitiv
nemati = imati
neodgovoran = odgovoran
neodgovornost = odgovornost
neodlučan = odlučan
neozbiljan = ozbiljan
neparan = paran
nepismen = pismen
neplivač = plivač
neplivačica = plivačica
neplodan = plodan
neproziran = proziran
nepušač = pušač
nepušačica = pušačica
nesiguran = siguran
neuredan = uredan
nevin = kriv
nezahvalan = zahvalan
nezahvalnost = zahvalnost
nezaposlen = zaposlen
nikad = uvijek
nizak = visok
nježan = grub
nježno = grubo
noć = dan
nov = star
obrana = napad
obuti = izuti
obuvanje = izuvanje
obuvati = izuvati
obziran = bezobziran
odbojan = privlačan
odbojan = privlačan
odgovoran = neodgovoran
odgovornost = neodgovornost
odjenuti = skinuti
odlazak = dolazak
odlučan = neodlučan
odnijeti = donijeti
odnositi = donositi
odsad = dosad
oduzeti = zbrojiti
oduzimati = zbrajati
optimist = pesimist
osjećajan = bezosjećajan
otvarati = zatvarati
otvoriti = zatvoriti
ozbiljan = neozbiljan
pakao = raj
pametan = glup
paran = neparan
pasiv = aktiv
pasiva = aktiva
pasivan = aktivan
pasivni = aktivni
pasivnost = aktivnost
patuljak = div
pesimist = optimist
pismen = nepismen
pismeno = usmeno
plitak = dubok
plivač = neplivač
plivačica = neplivačica
plodan = neplodan
plus = minus
pobijediti = izgubiti
pobjeda = poraz
podne = ponoć
ponoć = podne
popodne = dopodne
poraz = pobjeda
poslije = prije
poslijepodne = prijepodne
pozitiv = negativ
prazan = pun
prednaglasnica = zanaglasnica
prije = poslije
prijepodne = poslijepodne
privlačan = odbojan
prljav = čist
proklitika = enklitika
prošlost = budućnost
proziran = neproziran
pun = prazan
pušač = nepušač
pušačica = nepušačica
raj = pakao
rastrošan = škrt
rat = mir
razlika = zbroj
ružan = lijep
šapnuti = viknuti
šaptati = vikati
savitljiv = krut
sestrinski = bratski
siguran = nesiguran
širok = uzak
siromah = bogataš
siromahinja = bogatašica
siromašan = bogat
siromaštvo = bogatstvo
sjever = jug
sjeverni = južni
skriti = otkriti
skrivati = otkrivati
škrt = rastrošan
skup = jeftin
slab = jak
slabost = jakost
smislen = besmislen
smrtnost = besmrtnost
spor = brz
sprijeda = straga
spuštati = dizati
sreća = tuga
stajaćica = tekućica
star = mlad
staro = mlado
starost = mladost
start = cilj
šteta = korist
straga = sprijeda
stran = domaći
strog = blag
strogost = blagost
sutra = jučer
svijetao = taman
svršetak = početak
svući = navući
taman = svijetao
tekućica = stajaćica
težak = lagan
tuga = sreća
ući = izići
uključiti = isključiti
ulaz = izlaz
ulaziti = izlaziti
unajmiti = iznajmiti
unajmljivanje = iznajmljivanje
unajmljivati = iznajmljivati
unutrašnji = vanjski
uredan = neuredan
usmeno = pismeno
uvijek = nikad
uzak = širok
uzeti = dati
vanjski = unutrašnji
večer = jutro
večeras = jutros
vikati = šaptati
viknuti = šapnuti
višedimenzijski = jednodimenzijski
višekatni = jednokatni
višekatnica = jednokatnica
višekratan = jednokratan
visok = nizak
visok = nizak
voljeti = mrziti
vrijedan = bezvrijedan
vrijedno = bezvrijedno
vruć = hladan
zabava = dosada
zabavan = dosadan
zabrinut = bezbrižan
zahvalan = nezahvalan
zahvalnost = nezahvalnost
zanaglasnica = prednaglasnica
zapad = istok
zapadni = istočni
zaposlen = nezaposlen
zaposliti = otpustiti
zatvarati = otvarati
zatvoriti = otvoriti
završetak = početak
zbrajati = oduzimati
zbroj = razlika
zbrojiti = oduzeti
zdrav = bolestan
zdravlje = bolest
zimski = ljetni
živ = mrtav