admiral = admiralica
aktivist = aktivistica / aktivistkinja
alfa-mužjak = alfa-ženka
alkoholičar = alkoholičarka
alpinist = alpinistica / alpinistkinja
anglist = anglistica / anglistkinja
antialkoholičar = antialkoholičarka
arhitekt = arhitektica
arhivist = arhivistica
automehaničar = automehaničarka
autor = autorica
bacač = bacačica
bačvar = bačvarica
baka = deda
balerina = baletan
barun = barunica
biciklist = biciklistica / biciklistkinja 
bilježnik = bilježnica
blizanac = blizanka
bogataš = bogatašica
bojnica = bojnik
boksač =  boksačica
branitelj = braniteljica
brat = bratić
brigadir = brigadirka
bubnjar = bubnjarica
car = carica
cimer = cimerica
cura = dečko / dječak
čarobnica = čarobnjak
časnica = časnik
četrdesetogodišnjak = četrdesetogodišnjakinja
četverogodišnjak = četverogodišnjakinja
četvrtaš = četvrtašica
čistač = čistačica
članica = član
daltonist = daltonistica
desetnica = desetnik
desetogodišnjak = desetogodišnjakinja
dešnjak = dešnjakinja
direktor = direktorica
div = divkinja
divljak = divljakinja / divljakuša 
dizajner = dizajnerica
djevac = djevica
dječak = djevojčica / djevojka
dočasnica = dočasnik
doktor = doktorica
domaćica = domaćin
drugaš = drugašica
dvadesetogodišnjak = dvadesetogodišnjakinja
dvogodišnjak = dvogodišnjakinja
đavao = đavolica
fagotist = fagotistica
fizičar = fizičarka
flautist = flautistica
frizer = frizerka
frulaš = frulašica
gajdaš = gajdašica
general = generalica
gimnastičar = gimnastičarka
gitarist = gitaristica
gledatelj = gledateljica
glumac = glumica
gospodar = gospodarica
gospodin = gospođa
gost = gošća
govornica = govornik
harfist = harfistica
harmonikaš = harmonikašica
idealist = idealistica
igrač = igračica
informatičar = informatičarka
invalid = invalitkinja
inženjer = inženjerka
izdajica / izdajnik = izdajnica
jedinac = jedinica
jednogodišnjak = jednogodišnjakinja
jezikoslovac = jezikoslovka
junak = junakinja
kadet = kadetkinja
kandidat = kandidatkinja
kapetan = kapetanica
katolik = katolkinja
kći = sin
kipar = kiparica
klarinetist = klarinetistica
klavirist = klaviristica
književnica = književnik
knjižničar = knjižničarka
kolega = kolegica
konobar = konobarica
kontrabasist = kontrabasistica
konj = kobila
korisnica = korisnik
koronaš = koronašica
košarkaš = košarkašica
kozmetičar = kozmetičarka
kralj = kraljica
krojač = krojačica
kršćanin = kršćanka
ksilofonist = ksilofonistica
kuhar = kuharica
kum = kuma
lav = lavica
liječnica = liječnik
lijeričar = lijeričarka
lingvist = lingvistica
lisac = lisica
lovac = lovkinja
lutka = lutak
ljekarnica = ljekarnik
ljevak = ljevakinja
ljubimac = ljubimica
mačak = mačka
maćeha = očuh
mađioničar = mađioničarka
majka = otac
major = majorica
mama = tata
matematičar = matematičarka
materijalist = materijalistica
maturant = maturantica
mehaničar = mehaničarka
menadžer = menadžerica
mesar = mesarica
ministar = ministrica
mjenjačica = mjenjač
mladić = cura / djevojka
momak = cura / djevojka
mornar = mornarica
musliman = muslimanka
muškarac / muž = žena
mužjak = ženka
nadnarednica = nadnarednik
narednica = narednik
nastavnica = nastavnik
natjecatelj = natjecateljica
natporučnica = natporučnik
navijač = navijačica
nećak = nećakinja
neplivač = neplivačica
nepušač = nepušačica
nevozač = nevozačica
nogometaš = nogometašica
novinar = novinarka
oboist = oboistica
obrtnica = obrtnik
odbojkaš = odbojkašica
odgojitelj = odgojiteljica
oficir = oficirka
okulist = okulistica
orguljaš = orguljašica
osmaš = osmašica
ovan = ovca
pacijent = pacijentica
padobranac = partner / partnerica
pastir = pastirica
patak = patka
pedagog = pedagogica / pedagoginja
pedesetogodišnjak = pedesetogodišnjakinja
pekar = pekarica
petaš = petašica
petogodišnjak = petogodišnjakinja
pijanist = pijanistica
pisac = spisateljica
pjesnik = pjesnikinja
pješak = pješakinja
pjevač = pjevačica
planinar = planinarka
plavuša = plavušan
plesač = plesačica
plivač = plivačica
podstanar = podstanarka
policajac = policajka
političar = političarka
polubrat = polusestra
poljoprivrednica = poljoprivrednik
poručnica = poručnik
poštar = poštarica
potporučnica = potporučnik
potpukovnica = potpukovnik
poznanica = poznanik
pozornica = pozornik
prabaka = pradjed
pravoslavac = pravoslavka
predsjednica = predsjednik
prevoditelj = prevoditeljica
prijatelj = prijateljica
prodavač = prodavačica
profesor = profesorica
proizvođač = proizvođačica
prolaznica = prolaznik
prometnica = prometnik
protivnica = protivnik
prvak = prvakinja
prvaš = prvašica
psiholog = psihologinja
pukovnica = pukovnik
pura /purica = puran
pušač = pušačica
putnica = putnik
radnica = radnik
ranjenica = ranjenik
ratnica = ratnik
ravnatelj = ravnateljica
razvodnica = razvodnik
redovnica = redovnik
ribar = ribarica
ročnica = ročnik
roditelj = roditeljica
rođak = rođakinja
ronilac = roniteljica
rukometaš = rukometašica
saksofonist = saksofonistica
satnica = satnik
sedmaš = sedmašica
seljak = seljakinja
sestra = brat
sestrična = bratić
sin = kći
siromahinja = siromah
bogataš = bogatašica
skijaš = skijašica
skladatelj = skladateljica
slikar = slikarica
sluga = sluškinja
sopilaš = sopilašica
sportaš = sportašica
spremač = spremačica
stanar = stanarka
stanovnica = stanovnik
starac = starica
stočar = stočarica
stomatolog = stomatologica / stomatologinja
stranac = strankinja
stric = strina
stručnjak = stručnjakinja
student = studentica
sudac = sutkinja
sudionica = sudionik
suprug = supruga
susjed = susjeda
svetac = svetica
svirač = sviračica
šahist = šahistica
šestaš = šestašica
šumar = šumarica
tajnica = tajnik
taksist = taksistica
tamburaš = tamburašica
tenisač = tenisačica
terminolog = terminologinja
teta = tetak
timpanist = timpanistica
tračer = tračerica
trećaš = trećašica
trener = trenerica
trgovac = trgovkinja
tridesetogodišnjak = tridesetogodišnjakinja
trogodišnjak = trogodišnjakinja
trombonist = trombonistica
trubač = trubačica
turist = turistica
učenica = učenik
učitelj = učiteljica
ujak = ujna
umirovljenica = umirovljenik
umjetnica = umjetnik
unuk = unuka
vaterpolist = vaterpolistica
vatrogasac = vatrogaskinja
vegetarijanac = vegetarijanka
veslač = veslačica
veterinar = veterinarka
viceadmiral = viceadmiralica
violinist = violinistica
violist = violistica
violončelist = violončelistica
vjernica = vjernik
vjeroučitelj = vjeroučiteljica
vježbenica = vježbenik
vladar = vladarica
vodič = vodičica
vodnica = vodnik
vodoinstalater = vodoinstalaterka
vojnik = vojnikinja
vozač = vozačica
vrag = vražica
zamjenica = zamjenik
znanac = znanica
znanstvenica = znanstvenik
zubar = zubarica
žena = ženka
židov = židovka
župan = županica